	Phenopacket	Disease	/Users/carlo/Desktop/exomiser_results/pheval_disease_results	/Users/carlo/Desktop/elder_results_ip/pheval_disease_results	rank_decrease
1	Abdul_Wahab-2016-GCDH-Patient_5.json	OMIM:231670	2	159	157
2	Ajmal-2013-BBS1-IV-5_family_A.json	OMIM:209900	1	12	11
3	Al-Dosari-2010-TFAP2A-10-year-old_girl.json	OMIM:113620	54	16	-38
4	Al-Hashmi-2018-SNX14-IV-1.json	OMIM:616354	2	46	44
5	Al-Qattan-2018-SCARF2-proband.json	OMIM:600920	1	1	0
6	Al-Semari-2013-FGD1-II-1.json	OMIM:305400	4	45	41
7	AlSubhi-2016-ALG9-IV_5.json	OMIM:608776	1	9	8
8	Alazami-2016-ATP6V1E1-Family_5_-_IV_2.json	OMIM:617402	1	554	553
9	Ali-2017-MYH3-proband.json	OMIM:193700	1	36	35
10	Alzahrani-2018-EPG5-18-month_son.json	OMIM:242840	321	112	-209
11	Anazi-2017-NKX6-2-Patient_36-16DG1123.json	OMIM:617560	39	538	499
12	Arno-2017-ARHGEF18-Individual_1.json	OMIM:617433	173	33	-140
13	Arno-2017-ARHGEF18-Individual_2.json	OMIM:617433	173	33	-140
14	Arora-2019-COG8-proband.json	OMIM:611182	2718	2068	-650
15	Asgharzade-2018-GIPC3-Ahv-14_23.json	OMIM:601869	13	20	7
16	Avgeris-2017-TSC1-patient_6.json	OMIM:191100	3	2	-1
17	Avrahami-2008-ST14-patient.json	OMIM:602400	1	3	2
18	Badin-2017-RUNX1-Pedigree_I,_V_2.json	OMIM:601399	1	1	0
19	Baldi-2018-NKX6-2-F6,II-2.json	OMIM:617560	156	798	642
20	Bao-2019-COL6A1-II.1.json	OMIM:158810	621	73	-548
21	Bastaki-2017-CTCF-proband.json	OMIM:615502	355	418	63
22	Bee-2015-BBS2-II_2.json	OMIM:615981	9	15	6
23	Ben_Ammar-2013-MUSK-patient.json	OMIM:616325	323	28	-295
24	Bhatia-2018-PRPF31-IV_3.json	OMIM:600138	76	47	-29
25	Bhoj-2016-TBCK-1-1.json	OMIM:616900	2	122	120
26	Bhoj-2016-TBCK-1-2.json	OMIM:616900	2	25	23
27	Bhoj-2016-TBCK-2-1.json	OMIM:616900	2	977	975
28	Bhoj-2016-TBCK-3-1.json	OMIM:616900	14	396	382
29	Bhoj-2016-TBCK-4-1.json	OMIM:616900	2	563	561
30	Bhoj-2016-TBCK-4-2.json	OMIM:616900	1	3058	3057
31	Bhoj-2016-TBCK-5-1.json	OMIM:616900	3	17	14
32	Bhoj-2016-TBCK-6-1.json	OMIM:616900	99	169	70
33	Bhoj-2016-TBCK-6-2.json	OMIM:616900	1257	1261	4
34	Bhoj-2016-TBCK-8-1.json	OMIM:616900	2	296	294
35	Bicknell-2007-FLNB-19.json	OMIM:150250	1	2	1
36	Blanco-Kelly-2017-CDH3-Patient.json	OMIM:601553	6	102	96
37	Bluteau-2018-SAMD9L-UB049.json	OMIM:159550	176	259	83
38	Bluteau-2018-SAMD9L-UB081.json	OMIM:159550	233	637	404
39	Bluteau-2018-SAMD9L-UB085.json	OMIM:159550	54	440	386
40	Bluteau-2018-SAMD9L-UB612.json	OMIM:159550	119	36	-83
41	Boddrich-1997-NF1-0548.json	OMIM:162200	3	2	-1
42	Bordbar-2017-PRF1-8-year-old_boy.json	OMIM:603553	63	98	35
43	Bulut-2017-SETBP1-proposita.json	OMIM:269150	6	273	267
44	Calado-2005-UMOD-proband.json	OMIM:162000	3	5	2
45	Canosa-2018-SOD1-patient.json	OMIM:105400	228	165	-63
46	Cao-2018-FBN1-Patient_1.json	OMIM:154700	4	5	1
47	Cao-2018-FBN1-Patient_2.json	OMIM:154700	1	1	0
48	Cao-2018-FBN1-Patient_3.json	OMIM:154700	4	3	-1
49	Cao-2018-TGFBR2-Patient_4.json	OMIM:610168	6	2	-4
50	Caputo-2014-SMAD4-patient.json	OMIM:139210	1	88	87
51	Caro-Contreras-2019-ERF-proband.json	OMIM:617180	2	1	-1
52	Carre-2014-FOXE1-patient.json	OMIM:241850	4	1522	1518
53	Chabas-2005-GBA-_boy_weighing_1690_g.json	OMIM:608013	3	51	48
54	Chebly-2018-ERCC6-Patient_B.json	OMIM:133540	3	14	11
55	Chebly-2018-ERCC8-Patient_A.json	OMIM:216400	2	52	50
56	Chebly-2018-ERCC8-Patient_C.json	OMIM:216400	263	224	-39
57	Chelban-2017-NKX6-2-III-1.json	OMIM:617560	2	23	21
58	Chelban-2017-NKX6-2-IV-6.json	OMIM:617560	601	11	-590
59	Chen-2014-RUNX2-III_3.json	OMIM:119600	3	2	-1
60	Chen-2016-SAMD9L-II-4.json	OMIM:159550	228	11	-217
61	Chen-2016-SAMD9L-IV-1.json	OMIM:159550	3	365	362
62	Cheng-2018-FBN1-Family_1,_Patient_1.json	OMIM:614185	11	11	0
63	Chong-2016-TBCK-A-II-1.json	OMIM:616900	1	2	1
64	Chong-2016-TBCK-B-IV-4.json	OMIM:616900	1	2	1
65	Chong-2016-TBCK-B-IV-6.json	OMIM:616900	1	1	0
66	Chong-2016-TBCK-C-II-1.json	OMIM:616900	1	1	0
67	Chong-2016-TBCK-D-II-1.json	OMIM:616900	1	1	0
68	Claverie-Martin-2019-LMX1B-index.json	OMIM:161200	1	232	231
69	Cuchanski-2018-KIF5A-proband.json	OMIM:604187	38	42	4
70	Curtis-1978-FLCN-253.json	OMIM:135150	1	1	0
71	Dastsooz-2017-PANK2-Family_I_patient_I.json	OMIM:234200	15	1266	1251
72	Dastsooz-2017-PLA2G6-family_II_patient_II.json	OMIM:610217	4783	2351	-2432
73	Dauber-2014-SLC35C1-Proband_1.json	OMIM:266265	1	6	5
74	Delahaye-2007-CHD7-B_III-3.json	OMIM:214800	1	26	25
75	Delahaye-2007-CHD7-Patient_A_III-2.json	OMIM:214800	3	31	28
76	Devalla-2016-TECRL-Patient_1.json	OMIM:614021	8	8	0
77	Di_Nottia-2017-PARK7-proband.json	OMIM:606324	147	1076	929
78	Dias-2013-TRPS1-girl.json	OMIM:190350	10	321	311
79	Dikoglu-2015-LONP1-Patient_1.json	OMIM:600373	2	105	103
80	Dinani-2017-AAGAB-family_1_proband.json	OMIM:148600	2	13	11
81	Djamshidian-2009-VCP-II-3.json	OMIM:167320	1	1	0
82	Dobbs-2008-FLNB-patient.json	OMIM:150250	1	14	13
83	Dorboz-2017-NKX6-2-Patient_1_II-1.json	OMIM:617560	1267	56	-1211
84	Dorboz-2017-NKX6-2-Patient_3_II-3.json	OMIM:617560	790	132	-658
85	Dorboz-2017-NKX6-2-Patient_4_II-1.json	OMIM:617560	2482	213	-2269
86	Dougherty-2016-NPC1-The_proband.json	OMIM:257220	79	379	300
87	Du-2018-TINF2-proband.json	OMIM:613990	1	220	219
88	Ekvall-2015-NRAS-case_1.json	OMIM:613224	2	2	0
89	El-Harith-2009-MPL-FT2_VI_3.json	OMIM:601977	4	18	14
90	El-Jaick-2007-TGIF1-male_proband.json	OMIM:142946	1	2	1
91	Elsaadany-2016-WWOX-Patient_1.json	OMIM:616211	1444	396	-1048
92	Elsaid-2017-NT5C2-II.3.json	OMIM:613162	455	439	-16
93	Falik_Zaccai-2014-INSR-ISR1.json	OMIM:246200	30	3	-27
94	Falik_Zaccai-2017-PLAA-A-VI3.json	OMIM:617527	1	1	0
95	Fiscaletti-2018-SP7-II_5.json	OMIM:613849	1	1	0
96	Fregeau-2016-RERE-Subject_10.json	OMIM:616975	1	2044	2043
97	Fregeau-2016-RERE-Subject_1.json	OMIM:616975	40	13	-27
98	Fregeau-2016-RERE-Subject_2.json	OMIM:616975	1	54	53
99	Fregeau-2016-RERE-Subject_3.json	OMIM:616975	1	19	18
100	Fregeau-2016-RERE-Subject_4.json	OMIM:616975	1	203	202
101	Fregeau-2016-RERE-Subject_5.json	OMIM:616975	1	47	46
102	Fregeau-2016-RERE-Subject_6.json	OMIM:616975	1	368	367
103	Fregeau-2016-RERE-Subject_7.json	OMIM:616975	1	677	676
104	Fregeau-2016-RERE-Subject_8.json	OMIM:616975	1	241	240
105	Fregeau-2016-RERE-Subject_9.json	OMIM:616975	1	225	224
106	Fusco-2017-PMP22-Proband.json	OMIM:162500	101	23	-78
107	Gan-Or-2016-CAPN1-Family_A-V_2.json	OMIM:616907	1	8	7
108	Gan-Or-2016-CAPN1-Family_B-IV_1.json	OMIM:616907	72	8	-64
109	Gan-Or-2016-CAPN1-Family_C-IV_13.json	OMIM:616907	90	40	-50
110	Gao-2019-RUNX2-Family_A_II1.json	OMIM:119600	1	1	0
111	Gao-2019-RUNX2-Family_B_II1.json	OMIM:119600	1	1	0
112	Gao-2019-RUNX2-Family_D_II1.json	OMIM:119600	1	1	0
113	Ge-2019-TJP2-proband.json	OMIM:615878	1699	600	-1099
114	Gebbia-1997-ZIC3-III-1.json	OMIM:306955	1	2	1
115	Geiger-2017-TUBB2B-proband.json	OMIM:610031	298	115	-183
116	Gerding-2009-LITAF-Proband.json	OMIM:601098	2	1	-1
117	Giau-2018-PSEN2-proband.json	OMIM:606889	67	6	-61
118	Gong-2015-CBS-III_3.json	OMIM:236200	32	1099	1067
119	Gonzalez-Perez-2009-CAV3-I1.json	OMIM:614321	34	19	-15
120	Gowda-2017-MCOLN1-6_year_old_boy.json	OMIM:252650	221	183	-38
121	Gregor-2018-FBXO11-Individual_1.json	OMIM:618089	130	286	156
122	Grumach-2015-CARD9-Patient.json	OMIM:212050	1	12	11
123	Gu-2013-NOTCH2-proband.json	OMIM:102500	1	28	27
124	Gueguen-2013-ACTN1-proband.json	OMIM:615193	1	1	0
125	Guerreiro-2016-TBCK-II-3.json	OMIM:616900	202	1809	1607
126	Guerreiro-2016-TBCK-II-4.json	OMIM:616900	69	660	591
127	Gul-2006-CENPJ-IV-5.json	OMIM:608393	623	24	-599
128	Guo-2017-EXTL3-Patient_1.json	OMIM:617425	10	34	24
129	Guo-2018-KDM6A-3_month_old_boy.json	OMIM:300867	2	7	5
130	Guo-2018-KMT2D-3_month_old_boy.json	OMIM:300867	2	7	5
131	Habarou-2017-LIPT2-P1.json	OMIM:617668	1	1	0
132	Haliloglu-2017-PIEZO2-Patient.json	OMIM:617146	2	6	4
133	Hall-2017-PLAA-Family_A-IV_6.json	OMIM:617527	1	1	0
134	Hall-2017-PLAA-Family_D-Case_VIII-1.json	OMIM:617527	74	5	-69
135	Hamamy-2014-FYB1-IV_5.json	OMIM:273900	1	1	0
136	Hamzeh-2016-GPSM2-case_1.json	OMIM:604213	205	4288	4083
137	Han-2015-CHRDL1-III-1.json	OMIM:309300	1	1	0
138	Hara-2019-TGFBR1-patient.json	OMIM:609192	7	11	4
139	Harlalka-2013-HERC2-Pedigree_1A,VIII_8.json	OMIM:615516	3	5	2
140	Hashemi-Gorji-2019-MED23-IV.8.json	OMIM:614249	849	95	-754
141	Hayette-1995-EPB42-proposita.json	OMIM:612690	6	3	-3
142	Helmi-2017-LYST-patient.json	OMIM:214500	606	145	-461
143	Hernan-2004-STK11-20-year-old_woman_.json	OMIM:175200	1	1	0
144	Higuchi-2017-COL2A1-proband.json	OMIM:108300	45	590	545
145	Hilgert-2008-TMC1-935-IV_1.json	OMIM:600974	1	108	107
146	Hirabayashi-2018-SPINT2-two-month-old_male.json	OMIM:270420	1323	1627	304
147	Hirschhorn-1991-ADA-Patient.json	OMIM:102700	1	39	38
148	Ho-2018-GNPTAB-proband.json	OMIM:252500	2	59	57
149	Holmberg-1997-GP1BA-73_year_old_male.json	OMIM:231200	5	3	-2
150	Horvath-2014-GLRA1-proband.json	OMIM:149400	1329	164	-1165
151	Hsu-2017-SNAP29-The_patient.json	OMIM:609528	347	1186	839
152	Huang-2017-P3H1-proband.json	OMIM:610915	19	186	167
153	Hyun-2018-TP53RK-II-1.json	OMIM:617730	1	115	114
154	Imani-2019-BBS5-II_2.json	OMIM:615983	232	200	-32
155	Infante-2017-SMC3-patient_1.json	OMIM:610759	13	2	-11
156	Inlora-2017-APTX-V-3.json	OMIM:208920	201	245	44
157	Inui-2017-LONP1-Proband.json	OMIM:600373	122	1807	1685
158	Irfanullah-2015-NPR2-IV-2_family-A.json	OMIM:602875	1	12	11
159	Ishii-2013-KCNT1-Patient-1.json	OMIM:614959	919	99	-820
160	Itoh-Satoh-2002-TTN-JK109.json	OMIM:604145	1	1	0
161	Jagadisan-2017-PYGL-2-year_5-month_old_child.json	OMIM:232700	19	6	-13
162	Janecke-2015-SLC9A3-Patient_9.json	OMIM:616868	1	3	2
163	Jansen-2016-TMEM199-F1-II2.json	OMIM:616829	1	3	2
164	Jansen-2016-TMEM199-F2-II2.json	OMIM:616829	2	4	2
165	Jansen-2016-TMEM199-F3-II1.json	OMIM:616829	1	1	0
166	Janssen-2009-BSND-family-A-III3.json	OMIM:602522	10	2	-8
167	Javadiyan-2017-MAF-patient_CSA108.01.json	OMIM:601088	1517	68	-1449
168	Jeon-2014-LAMC2-patient.json	OMIM:226700	22	125	103
169	Ji-2017-ATRX-Proband.json	OMIM:301040	30	42	12
170	Jiang-2017-PPIB-second_fetus.json	OMIM:259440	1	254	253
171	Jin-2017-FBN1-patient.json	OMIM:102370	49	666	617
172	Jordan-2018-RERE-Subject_2.json	OMIM:616975	65	217	152
173	Jordan-2018-RERE-Subject_3.json	OMIM:616975	33	436	403
174	Jordan-2018-RERE-Subject_4.json	OMIM:616975	39	2487	2448
175	Jordan-2018-RERE-Subject_5.json	OMIM:616975	71	212	141
176	Jordan-2018-RERE-Subject_6.json	OMIM:616975	69	124	55
177	Jordan-2018-RERE-Subject_7.json	OMIM:616975	53	49	-4
178	Jordan-2018-RERE-Subject_8.json	OMIM:616975	45	71	26
179	Jordan-2018-RERE-Subject_9.json	OMIM:616975	155	620	465
180	Kantaputra-2014-FBLN5-4-year-old_Burmese_girl_.json	OMIM:219100	105	72	-33
181	Kato-2018-HNF1B-patient.json	OMIM:137920	37	9	-28
182	Khan-2017-HOXC13-IV-1.json	OMIM:614931	3	6	3
183	Kim-2016-LAMB3-proband.json	OMIM:104530	2	2	0
184	Kinnear-2017-TTC37-index.json	OMIM:222470	67	120	53
185	Kluijtmans-1996-CBS-patient.json	OMIM:236200	1	1368	1367
186	Kocoglu-2018-CAPN1-Fam1Pat1.json	OMIM:616907	48	6	-42
187	Kocoglu-2018-CAPN1-Fam2Pat1.json	OMIM:616907	48	6	-42
188	Konkolova-2017-GRHPR-patient.json	OMIM:260000	33	70	37
189	Kou-2018-ERCC6-index.json	OMIM:133540	1	939	938
190	Kremer-2016-TANGO2-F1_II.2.json	OMIM:616878	1	1	0
191	Kretz-2011-PYCR1-Patient_4.json	OMIM:612940	19	12	-7
192	Kruszka-2016-FGFR3-Proband_27.json	OMIM:602849	13	1956	1943
193	Kuptanon-2018-WNT1-proband.json	OMIM:615220	6	62	56
194	Kury-2017-PSMD12-Subject_1.json	OMIM:617516	2	8	6
195	Kury-2017-PSMD12-Subject_2.json	OMIM:617516	1	6	5
196	Kury-2017-PSMD12-Subject_3.json	OMIM:617516	51	294	243
197	Kury-2017-PSMD12-Subject_4.json	OMIM:617516	1	47	46
198	Lalani-2016-TANGO2-Subject_2.json	OMIM:616878	1	1	0
199	Lalani-2016-TANGO2-Subject_4.json	OMIM:616878	1	1	0
200	Lalani-2016-TANGO2-Subject_5.json	OMIM:616878	1	1	0
201	Lalani-2016-TANGO2-Subject_6.json	OMIM:616878	1	75	74
202	Lalani-2016-TANGO2-Suject_1.json	OMIM:616878	1	2	1
203	Lambe-2018-CAPN1-II-4.json	OMIM:616907	138	55	-83
204	Lesage-2016-VPS13C-Family_A,_V-2.json	OMIM:616840	955	723	-232
205	Lesage-2016-VPS13C-Family_B,_II-1.json	OMIM:616840	9	8	-1
206	Lesage-2016-VPS13C-Family_C,_II-1.json	OMIM:616840	428	101	-327
207	Li-2014-BBS4-4-year-old_female_patient.json	OMIM:615982	152	137	-15
208	Li-2018-STXBP1-P1.json	OMIM:612164	15	3	-12
209	Liberalesso-2017-SALL1-VMFS.json	OMIM:107480	3	733	730
210	Ling-2019-NHS-III_1.json	OMIM:302350	1	2	1
211	Lopez-2018-EP300-11.json	OMIM:613684	1	11	10
212	Lopez-2018-EP300-38.json	OMIM:613684	3	5	2
213	Luco-2016-DYRK1A-Patient_2.json	OMIM:614104	4	251	247
214	Luo-2016-COMP-II-1.json	OMIM:177170	30	9	-21
215	Lv-2016-TMEM38B-family2-patient2.json	OMIM:615066	163	2290	2127
216	Ma-2018-SPTA1-proband.json	OMIM:130600	29	191	162
217	Mackenroth-2016-ADAMTSL2-patient.json	OMIM:231050	157	94	-63
218	Magerus-Chatinet-2013-FASLG-patient.json	OMIM:601859	2	68	66
219	Maghami-2018-FKBP10-proband.json	OMIM:610968	1	16	15
220	Mattioli-2017-BRPF1-Individual_11_Family_F.json	OMIM:617333	174	56	-118
221	Mazzucchelli-2011-LAMA3-Proband.json	OMIM:226700	23	127	104
222	Mei-2015-NIPBL-Patient_1.json	OMIM:122470	2	564	562
223	Mei-2015-NIPBL-Patient_2.json	OMIM:122470	2	859	857
224	Metodiev-2016-TRMT10C-Subject_1.json	OMIM:616974	21	31	10
225	Metodiev-2016-TRMT10C-Subject_2.json	OMIM:616974	1	1	0
226	Miao-2018-CLCN1-man.json	OMIM:160800	4	11	7
227	Micaglio-2019-SCN5A-proband.json	OMIM:601144	172	54	-118
228	Michalska-2018-GTF2H5-male_infant.json	OMIM:616395	1	5	4
229	Mokbel-2013-TPM2-1A.json	OMIM:609285	12	67	55
230	Montgomery-2015-AMN-III_1.json	OMIM:261100	1	2	1
231	Moosa-1799-MTOR-index.json	OMIM:616638	33	4	-29
232	Moreau-Le_Lan-2018-ACTA1-Patient_5.json	OMIM:161800	13	23	10
233	Mundhofir-2013-FGFR2-Patient_1.json	OMIM:101200	31	21	-10
234	Mundhofir-2013-FGFR2-Patient_2.json	OMIM:101200	38	249	211
235	Mwasamwaja-2018-TGFB1-patient.json	OMIM:131300	17	2	-15
236	Nakajima-2013-B3GALT6-P7_F6.json	OMIM:271640	2	1	-1
237	Naz_Villalba-2016-NLRP3-proband.json	OMIM:191900	39	82	43
238	Nellist-2009-TSC1-II_3_Family_2.json	OMIM:191100	8	1	-7
239	Nevidomskyte-2017-SMAD3-54-year_old_woman.json	OMIM:613795	102	15	-87
240	Nguyen-2017-NPHS1-patient_1.json	OMIM:256300	1	6	5
241	Nicole-2014-AGRN-Patient_3_Kinship_2.json	OMIM:615120	220	194	-26
242	Niihori-2006-BRAF-CFC16.json	OMIM:115150	1	60	59
243	Ning-2015-MEN1-III-3.json	OMIM:131100	17	5	-12
244	Noch-2017-ATP13A2-Case_1.json	OMIM:606693	47	5	-42
245	Ockeloen-2012-CFL2-_Patient_1.json	OMIM:610687	1	1	0
246	Okamoto-2018-ASPM-patient.json	OMIM:608716	71	150	79
247	Oud-2017-EXTL3-AII-1.json	OMIM:617425	2	102	100
248	Oud-2017-EXTL3-BII-1.json	OMIM:617425	199	18	-181
249	Oud-2017-EXTL3-B_II-2.json	OMIM:617425	2	19	17
250	Oud-2017-EXTL3-C_II-1.json	OMIM:617425	252	156	-96
251	Oud-2017-EXTL3-D_IV-1.json	OMIM:617425	1	29	28
252	Oud-2017-EXTL3-E_II-1.json	OMIM:617425	198	491	293
253	Papanastasiou-2010-STAT3-12_year_old_girl.json	OMIM:147060	2	1	-1
254	Park-2014-DNM2-Patient_1.json	OMIM:160150	45	11	-34
255	Park-2016-GSN-III_5.json	OMIM:105120	587	4363	3776
256	Pasic-2013-NBN-12-year-old_girl.json	OMIM:251260	55	27	-28
257	Pastor-2018-SAMD9L-P5.json	OMIM:159550	299	256	-43
258	Pastor-2018-SAMD9L-P7.json	OMIM:159550	299	256	-43
259	Patsi-2018-PNPLA6-18_year-old_female.json	OMIM:275400	132	312	180
260	Paun-2013-RET-DM_patient.json	OMIM:171400	2	1	-1
261	Pipilas-2016-CALM1-Case_2.json	OMIM:616247	12	4	-8
262	Pipilas-2016-CALM2-Case_1.json	OMIM:616249	1	7	6
263	Prada-2014-CTSA-BAB3767.json	OMIM:256540	20	2468	2448
264	Qin-2017-NRL-II_2.json	OMIM:613750	64	68	4
265	Rejeb-2017-VPS13B-proposita.json	OMIM:216550	1	30	29
266	Reyes-de_la_Rosa-2018-JAG1-Proband.json	OMIM:118450	1	86	85
267	Rincon-2019-WRN-48-year-old_male.json	OMIM:277700	1	8	7
268	Ritelli-2013-COL5A1-AN_002501.json	OMIM:130000	22	3	-19
269	Ritelli-2014-TGFB2-proposita.json	OMIM:614816	1	1	0
270	Ritelli-2019-AEBP1-AN_006205.json	OMIM:618000	14	8	-6
271	Rohanizadegan-2018-DHCR24-proband.json	OMIM:602398	1053	262	-791
272	Romero-Quintana-2013-CTSC-Case_1P1.json	OMIM:245000	1	4	3
273	Salas-Alanis-2016-ANTXR1-14_year_old_brother.json	OMIM:230740	5	11	6
274	Salpietro-2018-DDX59-Patient_1.json	OMIM:174300	118	373	255
275	Sandal-2018-CHST14-3-year_old_boy.json	OMIM:601776	9	408	399
276	Savage-2016-FANCI-NCI-309-1.json	OMIM:609053	1	1	0
277	Sawal-2018-ADGRG1-Family_A,_II_2.json	OMIM:606854	2	464	462
278	Schaefer-2014-POLR1D-family_1_patient.json	OMIM:613717	1	2	1
279	Schormair-2018-VPS13C-VPS13C_case.json	OMIM:616840	182	64	-118
280	Schreckenbach-2014-TPM3-II.2.json	OMIM:609284	309	12	-297
281	Schussler-2018-ANTXR2-II-3_.json	OMIM:228600	144	1006	862
282	Schweizer-2014-HCN4-family_A_II_1.json	OMIM:163800	2	6	4
283	Seidlmayer-2018-RYR2-proband.json	OMIM:604772	84	25	-59
284	Sekelska-2017-SPRED1-P62.json	OMIM:611431	75	1071	996
285	Servian-Morilla-2016-POGLUT1-Patient_II.1.json	OMIM:617232	160	52	-108
286	Seven-2014-DYM-Patient_2.json	OMIM:223800	2	20	18
287	Shahid-2019-FERMT3-index.json	OMIM:612840	161	27	-134
288	Shalaby-2009-MYOT-patient.json	OMIM:609200	224	48	-176
289	Shen-2017-VPS13A-Patient-2.json	OMIM:200150	2	3	1
290	Sher-2014-CHSY1-IV-1.json	OMIM:605282	4	6	2
291	Shervin_Badv-2019-ASAH1-patient.json	OMIM:159950	1	3	2
292	Shlebak-2015-GP1BA-Patient_3.json	OMIM:231200	7	3	-4
293	Silva-2018-PREPL-proband.json	OMIM:616224	469	2001	1532
294	Skraban-2017-WDR26-Individual_1,_PPMD01P,_GEA055P.json	OMIM:617616	3	108	105
295	Skrabl-Baumgartner-2017-ADA2-patient_1.json	OMIM:615688	2	4	2
296	Slavotinek-2017-TBL1XR1-seven_year_old_male.json	OMIM:602342	151	479	328
297	Smith-2000-MITF-family_815.json	OMIM:103500	1	1	0
298	Smith-2017-ACP4-Family_1-IV_3.json	OMIM:617297	27	8	-19
299	Snanoudj-2019-SERAC1-proband.json	OMIM:614739	6	1	-5
300	Soumittra-2014-SLC4A11-Patient_1.json	OMIM:613268	3	36	33
301	Steinkellner-2015-ADAMTS10-18-year-old_woman.json	OMIM:277600	1	2	1
302	Stouffs-2018-RTTN-Patient_3.json	OMIM:614833	81	2	-79
303	Straniero-2018-OTUD6B-proband.json	OMIM:617452	400	63	-337
304	Suarez-Artiles-2018-OCRL-Patient_1.json	OMIM:309000	3	12	9
305	Suter-2016-USB1-patient.json	OMIM:604173	3	29	26
306	Szczałuba-2018-GNB1-proband.json	OMIM:616973	515	59	-456
307	Ta-Shma-2017-TMEM260-1-II-1.json	OMIM:617478	1	1	0
308	Ta-Shma-2017-TMEM260-2-II-4.json	OMIM:617478	1	1	0
309	Tadic-2017-CAPN1-Index.json	OMIM:616907	425	16	-409
310	Taghizade_Mortezaee-2015-ITGB2-P1.json	OMIM:116920	1	2	1
311	Takagi-2006-WNK1-Patient.json	OMIM:201300	3	1	-2
312	Tamhankar-2014-ROR2-Patient_1.json	OMIM:268310	3	1	-2
313	Tamhankar-2014-ROR2-Patient_2.json	OMIM:268310	29	1	-28
314	Tamura-2017-DHCR7-patient.json	OMIM:270400	1	19	18
315	Tan-2014-CDK5RAP2-patient.json	OMIM:604804	3868	1218	-2650
316	Tesi-2017-SAMD9L-II-4.json	OMIM:159550	60	2	-58
317	Tesi-2017-SAMD9L-III-1.json	OMIM:159550	158	102	-56
318	Tian-2018-ACVR1-patient.json	OMIM:135100	1	1	0
319	Tiecke-2001-FBN1-B15.json	OMIM:154700	3	2	-1
320	Tran-2015-GALT-FKT118.json	OMIM:230400	2	1617	1615
321	Travaglini-2017-CAPN1-index.json	OMIM:616907	325	63	-262
322	Truong-2010-RAI1-SMS324.json	OMIM:182290	2	230	228
323	Truong-2010-RAI1-SMS335.json	OMIM:182290	6	467	461
324	Twigg-2013-EFNB1-3269.json	OMIM:304110	1	2	1
325	Unger-2008-CCNQ-Case_2.json	OMIM:300707	1	1	0
326	Uysal-2017-KCNQ1-family_III-IV-5.json	OMIM:220400	28	45	17
327	Vajro-2018-TMEM199-Patient_1.json	OMIM:616829	1	3	2
328	Vajro-2018-TMEM199-Patient_2.json	OMIM:616829	1	3	2
329	Vajro-2018-TMEM199-Patient_3.json	OMIM:616829	8	7	-1
330	Van_Damme-2017-ATP6V1A-PIII_1.json	OMIM:617403	1	74	73
331	Van_Damme-2017-ATP6V1A-PIV_1.json	OMIM:617403	1	71	70
332	Van_Damme-2017-ATP6V1A-PV_1.json	OMIM:617403	1	40	39
333	Van_Damme-2017-ATP6V1E1-PII_1.json	OMIM:617402	2	57	55
334	Van_Damme-2017-ATP6V1E1-PI_1.json	OMIM:617402	2	122	120
335	Van_De_Weghe-2017-ARMC9-UW132-3.json	OMIM:617622	47	78	31
336	Van_Zwieten-2013-SLC4A1-c.1432-2A_T.json	OMIM:612653	3	4	1
337	Vogiatzi-2018-COL11A1-proband.json	OMIM:604841	55	2323	2268
338	Volpi-2017-EXTL3-Patient_1.json	OMIM:617425	24	538	514
339	Volpi-2017-EXTL3-Patient_2.json	OMIM:617425	44	1660	1616
340	Volpi-2017-EXTL3-Patient_3.json	OMIM:617425	23	6	-17
341	Vrtel-1996-TSC2-III-1.json	OMIM:613254	9	2	-7
342	Wakil-2018-RETREG1-F2_IV_1.json	OMIM:613115	20	15	-5
343	Wang-2016-CAPN1-R-III_1.json	OMIM:616907	135	296	161
344	Wang-2016-CAPN1-SAL-399-073.json	OMIM:616907	144	4	-140
345	Wang-2016-CAPN1-SAL-584-005.json	OMIM:616907	39	7	-32
346	Wang-2016-CAPN1-Tun66275.json	OMIM:616907	24	189	165
347	Wang-2017-OCA2-B.json	OMIM:203200	7	5	-2
348	Wang-2018-CRX-IV_5.json	OMIM:120970	201	28	-173
349	Wang-2018-SLC6A8-proband.json	OMIM:300352	1	195	194
350	Warnecke-2007-SPG7-II-3.json	OMIM:607259	25	15	-10
351	Watanabe-2016-COL5A2-patient.json	OMIM:130010	10	182	172
352	Whittock-2004-DLL3-II.6.json	OMIM:277300	2	1	-1
353	Wiltshire-2013-LMNA-II3.json	OMIM:616516	205	804	599
354	Windpassinger-2017-CDK10-F1-II_1.json	OMIM:617694	1	1	0
355	Wollnik-2003-PAX3-proposita.json	OMIM:148820	23	1	-22
356	Woo-2013-ASS1-5.json	OMIM:215700	2	32	30
357	Xie-2013-COMP-patient.json	OMIM:177170	3	7	4
358	Xiong-2019-ZIC2-proband.json	OMIM:609637	2	28	26
359	Xu-2017-CWC27-1_II-3.json	OMIM:250410	1	1	0
360	Xu-2017-CWC27-3_II-1.json	OMIM:250410	115	677	562
361	Xu-2017-CWC27-4_II-3.json	OMIM:250410	11	18	7
362	Xu-2017-CWC27-II-4.json	OMIM:250410	11	9	-2
363	Yalcin-Cakmakli-2014-FBXO7-ANK-07.json	OMIM:260300	36	16	-20
364	Yang-2016-MFN2-patient.json	OMIM:609260	10	27	17
365	Yao-2019-FGFR3-VI-5.json	OMIM:146000	1	14	13
366	Yoshida-1991-GLB1-KT.json	OMIM:230650	2	6	4
367	Zapata-Aldana-2019-TBCK-Patient_1.json	OMIM:616900	3	8	5
368	Zapata-Aldana-2019-TBCK-Patient_2.json	OMIM:616900	6	419	413
369	Zemojtel-2014-KMT2A-P1.json	OMIM:605130	96	109	13
370	Zenker-2007-KRAS-Patient_2.json	OMIM:609942	140	785	645
371	Zerkaoui-2015-GALC-child.json	OMIM:245200	412	291	-121
372	Zhang-2009-EDA-proband.json	OMIM:305100	29	1	-28
373	Zhang-2011-TYRP1-patient_2.json	OMIM:203290	6	15	9
374	Zhang-2016-RPS19-patient.json	OMIM:105650	43	995	952
375	Zhang-2017-FOXG1-Patient_1.json	OMIM:613454	1	23	22
376	Zhang-2017-FOXG1-Patient_2.json	OMIM:613454	1	9	8
377	Zhang-2017-FOXG1-Patient_3.json	OMIM:613454	4	18	14
378	Zhang-2017-FOXG1-Patient_4.json	OMIM:613454	19	92	73
379	Zhao-2008-KRT9-III_4.json	OMIM:144200	1	1	0
380	Zheng-2018-PNPLA6-II.2.json	OMIM:215470	7	29	22
381	Zhong-2016-PRPF3-020001-II_4.json	OMIM:601414	2	45	43
382	Zhou-2018-FBN2-IV_7.json	OMIM:121050	2	138	136
383	Zhu-2017-AIRE-V-1.json	OMIM:240300	3	1	-2
384	de_Vries-2012-FANCC-proband.json	OMIM:227645	2	6	4
385	van_Oorschot-2019-GFI1B-II_6.json	OMIM:187900	9	19	10
